###############
#P.##..##..##B#
#.....#.......#
#.##.###.###.##
#....#B#......#
##.#....#...#.#
#..........##.#
##..#.#..###B.#
###...#.......#
##......####..#
###...........#
###############