#############
#P.........B#
#..#.###.#..#
#.#.......#.#
#.#.##.##.#.#
#...#...#...#
#.#.......#.#
#...#...#...#
#.#.##.##.#.#
#.#.......#.#
#..#.###.#..#
#B.........B#
#############
