###################
#P..###...###....B#
#.......#.....###.#
#....##.....#.#...#
###...#.##.##....##
#.....#.#..#..##.##
#..####.......#..##
#.....#.#.#..###..#
###.......#.....#.#
#....###.####.....#
#...#.B#.#B....##.#
##..#....#...##...#
#......#.#...##.#.#
#.###.#..###......#
#........#...#...##
#......#...#.....##
###################
