###################
#P..###...###....B#
#.......#.....###.#
#....##.....#.#..##
###...#.##.##....##
#.....#.#..#..##.##
#..####.......#..##
#.....#.#.#..###.##
###.......#.....###
#....###.####.....#
#...#.B#.#B....##.#
##..#....#...##...#
#......#.#...##.#.#
#.###.#..###......#
#........#...#...##
#......#...#.....##
###################
